12
1,5,5,6,3,6,3,5,5,7,5,4
2,3,4,11,12,8,9,5,6,9,5,6
9,15,5,13,6,3,5,4,9,7,4,10
3,13,6,3,14,9,5,7,5,14,3,14
10,1,13,12,11,5,5,12,3,14,10,8
10,3,5,6,8,3,6,3,12,10,10,2
10,10,1,12,3,13,12,9,4,10,10,10
10,10,3,5,12,3,5,5,5,12,9,12
10,10,9,7,5,13,5,5,5,6,3,4
10,10,2,10,2,3,5,7,4,10,9,6
11,12,11,13,12,9,6,9,6,9,5,14
9,5,12,1,5,5,13,4,9,5,5,12